WE ./textures/walls/castle_1.xpm
EA ./textures/walls/castle_2.xpm
NO 			./textures/walls/castle_3.xpm
SO    ./textures/walls/castle_4.xpm
S1 			./textures/sprites/alien_1.xpm
S2    ./textures/sprites/alien_2.xpm

C 0, 0,0
F 0, 0, 0

111111111111111111111111111111111111111
101000000000000000000100000000111000001
101000000000000000000100000000111000001
101000000000000000000100000000111000001
101000000000000000000100002020111000001
101000000000000000000100000000111000001
10100000000000000000010000N000111000001
100000000000000000000000000000000000001
100000000000000000000000000000000000001
100000000000000001111000000000000000001
100000000000000001111000000000000000001
100000000000000000001000000000000000001
100000000000000000001111000000000000001
100000000000000000000001000000000000001
100011111111111111110001111111111111111
100010000000000000000000000000000000001
100010000000000000000000000000000000001
111111111111111111111111111111111111111
