WE ./textures/castle_blue_wall_512.xpm
EA ./textures/castle_light_shadow_wall_512.xpm
NO 			./textures/castle_orange_wall_512.xpm
SO    ./textures/castle_gray_wall_512.xpm

C 0, 0, 0
F 0, 0, 0

111111111111111111111111111111111111111
101000000000000000000100000000111000001
101000000000000000000100000000111000001
101000000000000000000100000000111000001
101000000000000000000100000000111000001
101000000000000000000100000000111000001
101000000000000000000100000000111000001
100000000000000000000000000000000000001
100000000000000000000000000000000000001
100000000000000001111000000000000000001
100022000000000001111000000000000000001
100000000000000000001000000000000000001
100000000000000000001111000000000000001
100000000000000000000001000000000000001
100011111111111111110001111111111111111
100010000000000000000000000000000000001
10N010000000000000000000000000000000001
111111111111111111111111111111111111111
