WE ./textures/greystone.xpm
EA ./textures/tonneau.xpm
NO 			./textures/purplestone.xpm
SO    ./textures/red.xpm

C 0, 0,0
F 170, 109,101

11111111
10011111
11000111
11000111
101N0101
11010011
11100011
11111111


