WE ./textures/greystone.xpm
EA ./textures/tonneau.xpm
NO 			./textures/purplestone.xpm
SO    ./textures/red.xpm

C 0, 240,90
F 170, 109,101

1111111111
1N1
111