WE ./textures/greystone.xpm
EA ./textures/tonneau.xpm
NO 			./textures/purplestone.xpm
SO    ./textures/red.xpm

C 0, 0,0
F 170, 109,101

1111111111
1100100001
1000000001
1000000001
1000000001
11000N0011
1000000001
1000000001
1100100011
1111111111
