WE ./textures/walls/doom_8.XPM
EA ./textures/walls/doom_6.XPM
NO 			./textures/walls/doom_7.XPM
SO    ./textures/walls/doom_3.XPM

C 0, 0,0
F 170, 109,101
11111111111111111111111
10011111111111111111111
1E000000000100010000111
11111000020000000000111
10000010011111000000011
11020011000000000001111
11100011100000200111111
11100011100100000000011
11102011100100002000001
11100000000100000000111
11111020011110000011111
11111101011110002000111
11111111111111111111111


