WE ./textures/greystone.xpm
EA ./textures/tonneau.xpm
NO 			./textures/purplestone.xpm
SO    ./textures/red.xpm

C 0, 0,0
F 170, 109,101

11111111
11000001
10000001
11000001
10000001
10000N01
11000011
11111111
