WE ./textures/walls/green_1.xpm
EA ./textures/walls/green_2.xpm
NO 			./textures/walls/green_3.xpm
SO    ./textures/walls/green_4.xpm

C 255, 255, 255
F 255, 255, 255

111111111111111111111111111111111111111
101000000000000000000100000000111000001
101000000000000000000100000000111000001
101000000000000000000100000000111000001
101000000000000000000100001010111000001
101000000000000000000100000000111000001
10100000000000000000010000N000111000001
100000000000000000000000000000000000001
100000000000000000000000000000000000001
100000000000000001111000000000000000001
100000000000000001111000000000000000001
100000000000000000001000000000000000001
100000000000000000001111000000000000001
100000000000000000000001000000000000001
100011111111111111110001111111111111111
100010000000000000000000000000000000001
100010000000000000000000000000000000001
111111111111111111111111111111111111111
